UUUUUUUUUUU
UUUUUUUUUUU
UUUUWUWUUUU
UUUUUUUUUUU
UUUWUUUWUUU
UUUWWWWWUUU
UUUUUUUUUUU
UUUUUUUUUUU