UUUUUUUU
UUUUUUUU
UWWUUWWU
UWUUUUWU
UUUUUUUU
UWUUUUWU
UWWUUWWU
UUUUUUUU
UUUUUUUU