UUUUUUUUUU
UUUUUUUUUU
UUWWWWWWUU
UUWWWWWWUU
UUWWUUUUUU
UUWWUUUUUU
UUWWUUWWUU
UUWWUUWWUU
UUUUUUUUUU
UUUUUUUUUU