UUUUUUUUUU
UUUUUUUUUU
UUWWWWWWUU
UUWUUUUWUU
UUWUWWUWUU
UUWUWWUWUU
UUWUWWUWUU
UUWUWWUWUU
UUUUWWUUUU
UUUUWWUUUU