UUUUUUUUUUU
UWUWUWUWUWU
UUUUUUUUUUU
WUWUWUWUWUW
UUUUUUUUUUU
UWUWUWUWUWU
UUUUUUUUUUU
WUWUWUWUWUW
UUUUUUUUUUU