UUUUUUUWWW
UUUUUUUUWW
UUWWUUUUUW
UUWWWUUUUU
UUUWWWUUUU
UUUUWWWUUU
UUUUUWWWUU
WUUUUUWWUU
WWUUUUUUUU
WWWUUUUUUU