UUUUUUUUUUUU
UUUUUUUUUUUU
UUWWWWWWWWUU
UUUWWWUWWWUU
UUUUUUUUUUUU
UUUUUUUUUUUU
UUWUUUUUUUUU
UUUWWWWWWWUU
UUUUUUUUUUUU
UUUUUUUUUUUU