UUUUWUUUUUUUUU
UUUUWUUUUUUUUU
UUUUWUUUUUUUUU
UUUUWUUUUUUUUU
UUUUWUUUUWUUUU
UUUUUUUUUWUUUU
UUUUUUUUUWUUUU
UUUUUUUUUWUUUU
UUUUUUUUUWUUUU