UUWUUUUUWUUUUU
UUWUUUUUWUUUUU
UUWUUWUUWUUWUU
UUWUUWUUWUUWUU
UUWUUWUUWUUWUU
UUWUUWUUWUUWUU
UUUUUWUUUUUWUU
UUUUUWUUUUUWUU