UUUUUUUUUUUU
UUUUUUUUUUUU
UUWWWUUWWWUU
UUVVWUUWVWUU
UUWWWUUWVWUU
UUWVVUUWVWUU
UUWWWUUWWWUU
UUUUUUUUUUUU
UUUUUUUUUUUU