UUUUUUUUUU
WWWWWWWWWU
UUUUUUUUUU
UWWWWWWWWW
UUUUUUUUUU
WWWWWWWWWU
UUUUUUUUUU
UWWWWWWWWU
UUUUUUUUUU