UWUUWUUUWW
UWUUUUWUUW
UUUWUUUUUU
WUUUUUWUUU
UUUWUUUUUU
WWUUUUUUUU
UUUUUUUWUU
UUUUWUUUUU
WWUUUUUWUU
UUUUWUUUUW