UUUUUUUUUUU
UUUUUWUUUUU
UUUUUWUUUUU
UUUUUWUUUUU
UUUUUWUUUUU
UWWWWWWWWWU
UUUUUWUUUUU
UUUUUWUUUUU
UUUUUWUUUUU
UUUUUWUUUUU
UUUUUUUUUUU