UUUUUUUUUUUUUUU
WWWWWWWWWWWWWWU
UUUUUUUUUUUUUWU
UWWWWWWWWWWWUWU
UWUUUUUUUUUWUWU
UWUWWWWWWWUWUWU
UWUWUUUUUWUWUWU
UWUWUWWWUWUWUWU
UWUWUWUUUWUWUWU
UWUWUWWWWWUWUWU
UWUWUUUUUUUWUWU
UWUWWWWWWWWWUWU
UWUUUUUUUUUUUWU
UWWWWWWWWWWWWWU
UUUUUUUUUUUUUUU