UUUUUUUUUUU
UUUUUUUUUUU
UUWUUUUUWUU
UUWUUUUUWUU
UUWUUUUUWUU
UUWWWWWWWUU
UUWUUUUUWUU
UUWUUUUUWUU
UUUUUUUUUUU
UUUUUUUUUUU